1111111111111111111111111111111111111111111
1111111111111111111111111111111111111111111
1100110000000001100000000000000000000000111
1100110000000001100000000000000000000000111
1100111111001111110011111100111111001111111
1100111111001111110011111100111111001111111
1100000211001100000011000000110011001100011
1100000011001100000011000000110011001100011
1100110000001100110000001100000011001100111
1100000000000000110000001100000011001100111
1100110011001100111111111100110011111100111
1100110011001100111111111100110011111100111
1130110011001100110000000000110000000000011
1130110011001100110000000000110000000000011
1100000011001100110011001100000011000000011
1100110011001100110011001100110011001111111
1100110011001100110011001100110011001111111
1100110011001100110000001100110011001100011
1100110011001100110000001100110011001100011
1100111111001100111111111100111111001100111
1100111111001100110011111100111111111111111
1100111111001100110011111100111111111111111
1100110000001100000000000000000000000000011
1111111111111111111111111111111111111111111
1111111111111111111111111111111111111111111