1111111111111111111111111111111111111111111
1111111111111111111111111111111111111111111
1110211001100000000000000011001100000110011
1110011001100000000000000011001100000110011
1110011001100111111111110011001100111110011
1110011001100111111111110011001100111110011
1100011001100110000000000011001100110000011
1100011001100110000000000011001100110000011
1110000001100110011000110011001100000000011
1110000001100110011000110011001100000011111
1111110001100110011000111111001111100111111
1111110001100110011000111111001111100111111
1100000001100110011000000000000001100110011
1100000001100110011000000000000001100110011
1100000000000110011000000110011000000000011
1111111111100110011111100110011111111111111
1111111111100110011111100110011111111111111
1100000001100110000000000110000000000000011
1100000001100110000000000110000000000000011
1111111001100111111111100111111111111100011
1111111001100111111001100111111111111100011
1110011001100111111001100000000000000000011
1100000001100000000001100000000000000000011
1111111111111111111111111111111111111111111
1111111111111111111111111111111111111111111