1111111111111111111111111111111111111111111
1111111111111111111111111111111111111111111
1100110000021100000011000000000000000000011
1100110011111100111111001111111111111100111
1100000011111100111111001111111111111100111
1100110011001100110000000000000011000000111
1100000011001100110000000000000011000000111
1100110000000000000011001100000011001100011
1100110000000000000011001100000011001100011
1100110011111111110011111100110011001100111
1100110011111111110011111100110011001100111
1100110011001100000000000000110011001100011
1100110011001100000000000000110011000000011
1100110011000000000000000000110011000000111
1100110011001111111111111100111111111100111
1100110011001111111111111100111111111100111
1100110011001100000011001100000000000000011
1100110011001100000011001100000000000000011
1100111111001111110011001111110011111111111
1100111111001111110011001111110011111111111
1100110011111111111111001100111111001111111
1100110011111111111111001100111111001111111
1100000000000000000000001100110000001100011
1111111111111111111111111111111111111111111
1111111111111111111111111111111111111111111