11111111111111111111111111111111
11111111111111111111111111111111
11010110001000100000100010000011
11310010101010101010001010101011
11010110101010001011111010101011
11310110111011111000001010101011
11010000001010001111111010101011
11300111101010111010000010101011
11101100101010000010111110101011
11201101101010101110100010101011
11100000101010101000101010101111
11001111101011100011101010100011
11111000001010101110001000111011
11000011111010100010111110001011
11011110001000111010100011111011
11010110111110101000101010000011
11010100011000101111101010111111
11010101010010101000101010100011
11010101010110101010101010101011
11000001000100000010001010001011
11111111111111111111111111111111
11111111111111111111111111111111