111111111111111111111111111111111111111111111111111111111111111111111111111111111
111111111111111111111111111111111111111110011111111111111111111100111111111111111 
110011000000000110000000000000000000000110010011000000000000001100110000001100111 
110011111001111110011111100111111001111110010011001111111111001100110011111100111 
110000001001100000011000000110011001100000010011001100000000001100110011000000011 
120011000001100110000001100000011001100110000011001100000011001100110000000000111 
110011001001100111111111100110011111100111110011001100110011111100111111001111111 
113011001001100110000000000110000000000000000011001100110000000000000011001100011 
110000001001100110011001100000011000000000000000001100110000001100110000000000111 
110011001001100110011001100110011001111111111111001100111111001100111111111111111 
110011001001100110000001100110011001100000000011001100000000001100000000000000011 
110011111001100111111111100111111001100111110011001111111111001111111111111111111 
110011111001100110011111111111111111111110010011001111110011001111111111111100111 
110011000001100000011000000000000000000000000011001100000011000000000000000000111 
110011001111100111111001111111111111100111111111001111111111111111111111001111111 
110000001001100110000000000000011000000110000000001100000000000000000011001100111 
110011000000000000011001100000011001100000010000000000110011000000110000000000111 
110011001111111110011111100110011001100111111111111100110011001100110011111111111 
110011001001100000000000000110011001100000010000001100110011001100110000000000011 
110011001000000000000000000110011000000110000011001100110000001100000000000000111 
110011001001111111111111100111111111100111110011001111110011111100111111111100111 
110011001001100000011001100000000000000000010000001100000011000000110000001100111 
110011111001111110011001111110011111111110011111001111110011001111110011001100111 
110011111111111111111001100111111001100111110011111100111111001111110011111100111 
110000000000000000000001100110000001100000010000001100110000001100110000001100111 
110011111111111110011111100110011111111110010011111100110011111100111111111100111 
111111111111111111111111111111111111111111111111111111111111111111111111111111111 