1111111111111111111111111111111111111111111
1111111111111111111111111111111111111111111
1100000031111111111111111111111111111111111
1100000001111111111111111111111111111111111
1100000001111111111111111111111111111111111
1130000001111111111111111111111111111111111
1100000001111111111111111111111111111111111
1100000001111111111111111111111111111111111
1100000031111111111111111111111111111111111
1130000041111111111111111111111111111111111
1111111111111111111111111111111111111111111
1111111111111111111111111111111111111111111
1111111111100111111111111111111111111111111
1111111111100111111111111111111111111111111
1111111100000001110000000000000000000000011
1111111100000001110000000000111000000000011
1111111100000000000000000000111000000000411
1111111111111111111111110011111111111111111
1111111111111111111111110011111111111111111
1111111111111111111111111111111111111111111
1111111111111111111111111111111111111111111
1100000000000110000001100000011000200000011
1100000001100110011001100110011001100000011
1100000001100000011000000110000001100000011
1111111111111111111111111111111111111111111