1111111111111111111111111111111111111111111
1111111111111111111111111111111111111111111
1110000311111111111111111111111111111111111
1110000011111111111111111111111111111111111
1113000011111111111111111111111111111111111
1110000311111111111111111111111111111111111
1113000411111111111111111111111111111111111
1111111111111111111111111111111111111111111
1111111111111111111111111111111111111111111
1111111111100111111111111111111111111111111
1111111111100111111111111111111111111111111
1111111000000001110000000000000011111111111
1111111000000001110000001110000011111111111
1111111000000000000000001110000411111111111
1111111111111111111100111111111111111111111
1111111111111111111100111111111111111111111
1111111111111111111111111111111111111111111
1111111111111111111111111111111111111111111
1111111100000110000001100020000011111111111
1111111100000110011001100110000011111111111
1111111100000000011000000110000011111111111
1111111111111111111111111111111111111111111
1111111111111111111111111111111111111111111
1111111111111111111111111111111111111111111
1111111111111111111111111111111111111111111