1111111111111111111111111111111111111111111
1111111111111111111111111111111111111111111
1102110000000001100000000000000000000000111
1100110000000001100000000000000000000000111
1103111111001111100011111100111111001111111
1103111111001111100011111100111111001111111
1103000011001100000011000000110011001100011
1103000011001100000011000000110011001100011
1100110000001100110000001100000011001100011
1100110000001100110000001100000011001100011
1100110011001100111111111100110011111100011
1100110011001100111111111100110011111100011
1100110011001100110000000000110000000000011
1100110011001100110000000000110000000000011
1100000011001100110011001100000011000000011
1100110011001100110011001100110011001111111
1100110011001100110011001100110011001111111
1100110011000000110000001100110011001100011
1100110011000000110000001100111111001100011
1100111111001100110011001100111111001100011
1100111111001100110011001100110011111100011
1100110000001100000011001100110011111100011
1100110000001100000000000000000000000000011
1111111111111111111111111111111111111111111
1111111111111111111111111111111111111111111