1111111111111111111111111111111110000000000
1111111111111111111111111111111110000000000
1100110000000001100000000000000000000000000
1133110000000001100000000000000000000000000
1102111111001111100011111100111100000000000
1100111111001111100011111100111100000000000
1100000011001100000011000000110000000000000
1100000011001100000011000000110000000000000
1100110000001100110000001100000000000000000
1100110000001100112000001100000000000000000
1100110011001100111111111100110000000000000
1100110011001100111111111100110000000000000
1100110011000000110000000000110000000000000
1100110011000000110000000000110000000000000
1100000011001100110011001100000000000000000
1100000011001100110011001100000000000000000
0000000000000000000000000000000000000000000
0000000000000000000000000000000000000000000
0000000000000000000000000000000000000000000
0000000000000000000000000000000000000000000
0000000000000000000000000000000000000000000
0000000000000000000000000000000000000000000
0000000000000000000000000000000000000000000
0000000000000000000000000000000000000000000
0000000000000000000000000000000000000000000