1111111111111111111111111111111111111111111
1111111111111111111111111111111111111111111
1100110000000001100000000000000001111111111
1100110000000001100000000000000031111111111
1100111111001111100011111100111111111111111
1100111111001111100011111100111111111111111
1100000011001100000011000000110011111111111
1100000011001100000011000000110011111111111
1100110000001100110000001100000011111111111
1100110000001100112000001100000011111111111
1100110011001100111111111100110011111111111
1100110011001100111111111100110011111111111
1100110011000000110000000000110000111111111
1100110011000000110000000000110000111111111
1100000011001100110011001100000011111111111
1100000011031100110011001100000011111111111
1111111111111111111111111111111111111111111
1111111111111111111111111111111111111111111
1111111111111111111111111111111111111111111
1111111111111111111111111111111111111111111
1111111111111111111111111111111111111111111
1111111111111111111111111111111111111111111
1111111111111111111111111111111111111111111
1111111111111111111111111111111111111111111
1111111111111111111111111111111111111111111