1111111111111111111111111111111111111111111
1111111111111111111111111111111111111111111
1100000001130000000000000000001100111111111
1100000001100000000000000000001100111111111
1100011000000111111111110011001100111111111
1100011000000111111111110011001100111111111
1100011111100000000000000011001100111111111
1100011111100000000000000011001100111111111
1100000001100110011000110011000000111111111
1100000001100110011000110011000000111111111
1111110001100000011000111111001111111111111
1111110001100000011020111111001111111111111
1100000001100110011000000000000031111111111
1100000001100110011000000000000001111111111
1100000000000110011000000110000001111111111
1100111111100110011111100110011111111111111
1100111111100110011111100110011111111111111
1111111111111111111111111111111111111111111
1111111111111111111111111111111111111111111
1111111111111111111111111111111111111111111
1111111111111111111111111111111111111111111
1111111111111111111111111111111111111111111
1111111111111111111111111111111111111111111
1111111111111111111111111111111111111111111
1111111111111111111111111111111111111111111