1111111111111111111111111111111111111111111
1111111111111111111111111111111111111111111
1100110000000000000000001111111111000000011
1102110011111100111111001111111111000110011
1100000011111100111111000000000011000110011
1100000011001100110000000000000011000000011
1100110011001100110000000000000011000000011
1100110000000000000011001100000011000110011
1100110000000000000011001100000011003110011
1100110011111111110011111100110011000110011
1100110011111111110011111100110011000110011
1100110011001100000000000000110011000110011
1100110011001100000000000000110011000000011
1100110011000000000000000000110011000000011
1100000011001111111111111100111111111100011
1100000011001111111111111100111111111100011
1100110011001100000000000000000000000000011
1100113011001100000000000000000000000000011
1100111111001111110011001111110011111111011
1100111111201111110011001111110011111111011
1100110011111100111111001100110011031100011
1100110011111100111111001100110011001100011
1100000000000000000000001100000000001100011
1111111111111111111111111111111111111111111
1111111111111111111111111111111111111111111