1111111111111111111111111111111111111111111
1111111111111111111111111111111111111111111
1120110000000000000000001111001111100000011
1100110000000000000000001111001111100000011
1100110011111100110011001111001111100110011
1100110011111100110011000000000000000110011
1100000011001100110011000000000000000000011
1100000011001111110000001100110000000000011
1111110011001111110000001100110011100110011
1111110000000000000011000000000011100110011
1100000000000000000011000000000011100000011
1100000011111111110011111100110011100110011
1100000011111111110011111100110011100110011
1100000011001100000000000000110011100000011
1100110011001100000000000000110011100000011
1100110000001111111100111111110000000110011
1100000000001111111100111111110000000110011
1111111111000000110000000011110011100000011
1111111111000000110000000011110011100000011
1100110000001100000011110011110000000110011
1100110000001100000011110011110000000110011
1100000011000000110000000000000011100000011
1100000011000000110000000000000011100000011
1111111111111111111111111111111111111111111
1111111111111111111111111111111111111111111
