1111111111111111111111111111111111111111111
1111111111111111111111111111111111111111111
1100000000000000000021100000000000000000011
1100111111001111111111111111111111001111111
1100111111001111111111111111111111001111111
1100000000001100000000001100000011001100111
1100000000001100000000001100000011001100111
1100011000000000110011000000110000000000111
1100011000000000110011000000110000000000111
1111111111111100110011001100110011111111111
1111111111111100110011001100110011111111111
1100011000001100110011001100110000000000111
1100011000000000110000001100000000000000111
1100000011000000110000001100000000000000111
1111110011001111110011111100111111111100111
1111110011001111110011111100111111111100111
1100000000001100000011000000110000001100111
1100000000001100000011000000110000001100111
1100111111001111110011001100110011001100111
1100111111001111110011001100110011001100111
1111110011001100111111001100110011111100111
1111110011001100111111001100110011111100111
1100000000001100000000001100110000000000111
1111111111111111111111111111111111111111111
1111111111111111111111111111111111111111111